20 15
....................
....................
....####....####....
..##....####....##..
.#................#.
.#................#.
.#................#.
.#................#.
..#..............#..
...##..........##...
.....##......##.....
.......##..##.......
.........##.........
....................
....................
....................
....................
....................
....................
....................